Структура сайта:
	Dropdawn menu:
		В Тверской области:
			Города - tver-cities
			Экскурсионные туры - tver-excursions
			Программы приёма - tver-program
			Гостиницы и отели - tver-hotels
		В России:
			Экскурсионные туры - russia-tours
			Теплоходные круизы - russia-ship-cruises
			Гостиницы и отели - russia-hotels
		За границей:
			Направления - world-routes
			Круизы - world-cruises
			Автобусные туры - world-bus-tours
			Авиа и Ж/Д туры - world-air-rw-tours
		Информация для туристов - info-for-tourists
	Верхнее меню:
		Главная
			Театры и мюзиклы - Theaters-and-musicals
			Туры выходного дня - Weekend-tours
			Многодневные туры - Multi-day-tours
			Для школьников - For-school
			Речные круизы - River-cruises
			Горящие туры - Hot-tours
			Концерты - Concerts
			Корпоративы - Corporative
		Поиск - search
		О компании - about
		Галерея - gallery
		Отзывы - reviews
		Контакты - contacts
		Партнеры - partners